30
10
##############################
#                            #
#    ######                  #
#         #              #   #
#         #              #   #
#                        #   #
#                            #
#                            #
#                            #
##############################