30
10
##############################
#                            #
#    ######                  #
#         #              #   #
#         #######        #   #
#                        #   #
#                            #
#                            #
#            ###             #
##############################